WWWWWWWWWWWWWWWWWWWWWWWWWWWW
WFFFFFFFFFFFFWWFFFFFFFFFFFFW
WFWWWWFWWWWWFWWFWWWWWFWWWWFW
WUWWWWFWWWWWFWWFWWWWWFWWWWUW
WFWWWWFWWWWWFWWFWWWWWFWWWWFW
WFFFFFFFFFFFFWWFFFFFFFFFFFFW
WFWWWWFWWFWWWWWWWWFWWFWWWWFW
WFWWWWFWWFWWWWWWWWFWWFWWWWFW
WFFFFFFWWFFFFWWFFFFWWFFFFFFW
WWWWWWFWWWWWSWWSWWWWWFWWWWWW
SSSSSWFWWWWWSWWSWWWWWFWSSSSS
SSSSSWFWWSSSSSSSSSSWWFWSSSSS
SSSSSWFWWSWWWSSWWWSWWFWSSSSS
WWWWWWFWWSWSGSSGSWSWWFWWWWWW
SSSSSSFSSSWSSSSSSWSSSFSSSSSS
WWWWWWFWWSWSGSSGSWSWWFWWWWWW
SSSSSWFWWSWWWWWWWWSWWFWSSSSS
SSSSSWFWWSSSSFFSSSSWWFWSSSSS
SSSSSWFWWSWWWWWWWWSWWFWSSSSS
WWWWWWFWWSWWWWWWWWSWWFWWWWWW
WFFFFFFFFFFFFWWFFFFFFFFFFFFW
WFWWWWFWWWWWFWWFWWWWWFWWWWFW
WFWWWWFWWWWWFWWFWWWWWFWWWWFW
WUFFWWFFFFFFFPSFFFFFFFWWFFUW
WWWFWWFWWFWWWWWWWWFWWFWWFWWW
WWWFWWFWWFWWWWWWWWFWWFWWFWWW
WFFFFFFWWFFFFWWFFFFWWFFFFFFW
WFWWWWWWWWWWFWWFWWWWWWWWWWFW
WFWWWWWWWWWWFWWFWWWWWWWWWWFW
WFFFFFFFFFFFFFFFFFFFFFFFFFFW
WWWWWWWWWWWWWWWWWWWWWWWWWWWW
